TILEMAP
32 20 							-- Size of tile map in tiles
18 18 							-- Tile size & block size
images/tileset.png 	-- Tilesheet
32 6 								-- Number of tiles in tilesheet
31 31 32 31 31 32 31 32 31 32 31 32 31 32 162 0 21 0 128 32 31 32 31 32 31 32 31 32 31 32 31 32
32 31 32 31 31 31 32 31 32 31 32 31 32 31 162 0 21 0 129 31 32 31 32 31 32 31 32 31 32 31 32 31
31 31 32 31 31 32 31 32 31 32 31 32 31 32 162 0 21 0 129 32 31 32 31 32 31 32 31 32 31 32 31 32
32 31 32 31 31 31 32 31 32 31 32 31 32 31 162 0 21 0 128 31 32 31 32 31 32 31 32 31 32 31 32 31
31 31 32 31 31 32 31 32 31 32 31 32 31 32 162 0 21 0 129 32 31 32 31 32 31 32 31 32 31 32 31 32
32 31 32 31 31 31 32 31 32 31 32 31 32 31 162 0 21 0 128 31 32 31 32 31 32 31 32 31 32 31 32 31
26 26 24 23 26 24 24 23 26 23 26 24 23 23 0 0 21 0 0 26 24 23 23 26 23 24 24 26 26 24 23 24
0 0 0 0 0 0 0 0 0 0 0 0 0 0 0 0 21 0 0 0 0 0 0 0 0 0 0 0 0 0 0 160
0 0 0 0 0 0 0 0 1 20 1 0 0 0 1 1 2 1 1 1 1 0 0 0 0 0 0 0 0 0 0 160
0 0 0 0 0 0 0 0 23 21 24 0 0 0 24 26 24 23 24 26 23 0 0 0 0 0 0 0 0 0 0 160
0 0 0 0 0 0 0 0 0 21 0 0 0 0 0 0 0 0 0 0 0 0 0 0 0 0 0 0 0 0 0 160
0 0 0 0 0 0 0 0 0 21 0 0 0 0 0 0 0 0 0 0 0 0 0 0 0 0 0 0 0 0 0 160
0 0 1 1 1 1 1 1 1 2 1 0 0 0 0 0 0 0 0 0 0 0 0 0 0 0 0 0 0 0 0 160
0 0 26 24 24 26 24 23 26 24 23 0 0 0 0 0 0 0 0 0 0 1 0 0 0 0 0 1 1 1 1 160
0 0 0 0 0 0 0 0 0 0 0 0 0 0 0 0 0 0 0 0 1 1 0 0 0 0 0 24 26 26 23 160
0 0 0 0 0 0 0 0 0 0 0 0 0 0 0 0 0 0 0 0 23 24 0 0 0 0 0 0 0 0 0 160
0 0 0 0 0 0 0 0 0 0 0 0 0 0 0 0 0 0 0 0 0 0 0 0 0 0 0 0 0 0 0 160
53 54 53 53 54 54 53 54 53 53 54 54 53 54 53 53 54 54 53 54 53 53 54 54 53 54 53 53 54 54 53 53
47 48 48 48 48 47 47 48 48 47 48 47 47 48 48 47 48 47 47 48 48 47 48 47 47 48 48 47 48 47 47 48
47 48 48 48 48 47 47 48 48 47 48 47 47 48 48 47 48 47 47 48 48 47 48 47 47 48 48 47 48 47 47 48
