TILEMAP
32 20 							-- Size of tile map in tiles
18 18 							-- Tile size & block size
images/tileset.png 	-- Tilesheet
32 6 								-- Number of tiles in tilesheet
31 31 32 31 31 32 31 32 31 32 31 32 31 32 31 32 31 32 31 32 31 32 31 32 31 32 31 32 31 32 31 32
32 31 32 31 31 31 32 31 32 31 32 31 32 31 32 31 32 31 32 31 32 31 32 31 32 31 32 31 32 31 32 31
31 31 32 31 31 32 31 32 31 32 31 32 31 32 31 32 31 32 31 32 31 32 31 32 31 32 31 32 31 32 31 32
32 31 32 31 31 31 32 31 32 31 32 31 32 31 32 31 32 31 32 31 32 31 32 31 32 31 32 31 32 31 32 31
31 31 32 31 31 32 31 32 31 32 31 32 31 32 31 32 31 32 31 32 31 32 31 32 31 32 31 32 31 32 31 32
32 31 32 31 31 31 32 31 32 31 32 31 32 31 32 31 32 31 32 31 32 31 32 31 32 31 32 31 32 31 32 31
162 26 24 23 26 24 24 23 26 23 26 24 23 23 26 26 24 24 128 162 24 23 23 26 23 24 24 26 26 24 23 24
162  0 0 0 0 0 0 0 0 0 0 0 0 0 0 0 0 0 0 0 0 0 0 0 0 0 0 0 0 0 0 0
162  0 0 0 0 0 0 0 0 0 0 0 0 0 0 0 0 0 0 0 0 0 0 0 0 0 0 0 0 0 0 0
162  0 0 0 0 0 0 0 0 0 0 0 0 0 0 0 0 0 0 0 0 0 0 0 0 0 0 0 0 0 0 0
162  0 0 0 0 0 0 0 0 0 0 0 0 0 0 0 0 0 129 162 0 0 0 0 0 0 0 0 0 0 0 0
162  1 1 0 0 0 0 0 0 0 0 0 0 0 0 0 0 0 128 162 0 0 0 0 0 0 0 1 1 1 1 1
162  23 23 0 0 0 0 0 128 162 0 0 0 0 0 0 0 0 0 0 0 0 0 0 0 0 0 23 20 24 24 24
162  0 0 0 69 0 0 0 128 162 0 0 0 0 0 0 0 0 0 0 0 0 0 0 0 0 0 0 21 0 0 0
162  0 0 0 69 0 0 0 128 162 0 0 0 0 0 0 0 1 1 0 0 0 0 0 0 0 0 0 21 0 0 0
162  0 0 0 69 0 0 0 128 162 0 0 0 0 0 0 0 0 23 24 0 0 0 0 0 0 0 0 21 0 0 0
1 1 1 1 1 1 1 1 128 162 1 1 1 1 1 1 1 1 1 1 1 1 1 1 1 1 1 1 2 1 1 1 
53 54 53 53 54 54 53 54 53 53 54 54 53 54 53 53 54 54 53 54 53 53 54 54 53 54 53 53 54 54 53 53
47 48 48 48 48 47 47 48 48 47 48 47 47 48 48 47 48 47 47 48 48 47 48 47 47 48 48 47 48 47 47 48
47 48 48 48 48 47 47 48 48 47 48 47 47 48 48 47 48 47 47 48 48 47 48 47 47 48 48 47 48 47 47 48
