TILEMAP
32 20 							-- Size of tile map in tiles
18 18 							-- Tile size & block size
images/tileset.png 	-- Tilesheet
32 6 								-- Number of tiles in tilesheet
31 31 32 31 31 32 31 32 31 32 31 32 31 32 31 32 31 32 31 32 31 32 31 32 31 32 31 32 31 32 31 32
32 31 32 31 31 31 32 31 32 31 32 31 32 31 32 31 32 31 32 31 32 31 32 31 32 31 32 31 32 31 32 31
31 31 32 31 31 32 31 32 31 32 31 32 31 32 31 32 31 32 31 32 31 32 31 32 31 32 31 32 31 32 31 32
32 31 32 31 31 31 32 31 32 31 32 31 32 31 32 31 32 31 32 31 32 31 32 31 32 31 32 31 32 31 32 31
31 31 32 31 31 32 31 32 31 32 31 32 31 32 31 32 31 32 31 32 31 32 31 32 31 32 31 32 31 32 31 32
32 31 32 31 31 31 32 31 32 31 32 31 32 31 32 31 32 31 32 31 32 31 32 31 32 31 32 31 32 31 32 31
31 0 0 0 0 0 0 0 0 0 0 0 0 0 0 0 0 0 0 0 0 0 0 0 0 0 0 0 0 0 0 160
193 0 0 0 0 0 0 0 0 0 0 0 0 0 0 0 0 0 0 0 0 0 0 0 0 0 0 0 0 0 0 160
193 0 0 0 0 0 0 0 1 20 1 0 0 0 1 1 1 1 1 1 1 0 0 0 0 0 0 0 0 0 0 160
193 0 0 0 0 0 0 0 23 21 24 0 0 0 24 26 24 23 24 26 23 0 0 0 0 0 0 0 0 0 0 160
193 0 0 0 0 0 0 0 0 21 0 0 0 0 0 0 0 0 0 0 0 0 0 0 0 0 0 0 0 0 0 0
193 0 0 0 0 0 0 0 0 21 0 0 0 0 0 0 0 0 0 0 0 0 0 0 0 0 0 0 0 0 0 0
193 0 1 1 1 20 1 1 1 2 1 0 0 0 0 0 0 0 0 0 0 0 0 0 0 0 0 0 0 0 0 0
193 0 26 24 21 26 24 23 26 24 23 0 0 0 0 0 0 0 0 0 0 1 0 0 0 0 0 1 1 1 1 160
193 0 0 0 21 0 0 0 0 0 0 0 0 0 0 0 0 0 0 0 1 24 0 0 0 0 0 24 26 26 23 160
193 0 0 0 21 0 0 0 0 0 0 0 0 0 0 0 20 1 1 0 23 0 0 0 0 0 0 0 0 0 0 160
193 0 0 0 21 0 0 0 0 0 0 0 0 0 0 0 21 23 26 0 0 0 0 0 0 0 0 0 0 0 0 160
85 86 85 86 2 86 85 86 85 86 85 86 85 86 85 86 85 86 85 86 85 86 85 86 85 86 85 86 85 86 85 86
79 80 79 80 79 80 79 80 79 80 79 80 79 80 79 80 79 80 79 80 79 80 79 80 79 80 79 80 79 80 79 80
80 79 80 79 80 79 80 79 80 79 80 79 80 79 80 79 80 79 80 79 80 79 80 79 80 79 80 79 80 79 80 79
