TILEMAP
32 20 							-- Size of tile map in tiles
18 18 							-- Tile size & block size
images/tileset.png 	-- Tilesheet
32 6 								-- Number of tiles in tilesheet
31 31 32 31 31 32 31 32 31 32 31 32 31 32 31 32 31 32 31 32 31 32 31 32 31 32 31 32 31 32 31 32
32 31 32 31 31 31 32 31 32 31 32 31 32 31 32 31 32 31 32 31 32 31 32 31 32 31 32 31 32 31 32 31
31 31 32 31 31 32 31 32 31 32 31 32 31 32 31 32 31 32 31 32 31 32 31 32 31 32 31 32 31 32 31 32
32 31 32 31 31 31 32 31 32 31 32 31 32 31 32 31 32 31 32 31 32 31 32 31 32 31 32 31 32 31 32 31
31 31 32 31 31 32 31 32 31 32 31 32 31 32 31 32 31 32 31 32 31 32 31 32 31 32 31 32 31 32 31 32
32 31 32 31 31 31 32 31 32 31 32 31 32 31 32 31 32 31 32 31 32 31 32 31 32 31 32 31 32 31 32 31
162 26 129 162 26 24 129 162 26 23 129 162 23 23 26 26 24 24 23 26 129 162 23 26 23 24 24 26 26 24 23 24
0 0 0 0 0 0 129 162 0 0 129 162 0 0 0 0 0 0 0 0 129 162 0 0 0 0 0 0 0 0 0 0
0 0 0 0 0 0 129 162 0 0 129 162 0 0 0 0 0 0 0 0 129 162 0 0 0 0 0 0 0 0 0 0
0 0 0 0 0 0 0 0 0 0 129 162 0 0 0 0 0 0 0 0 0 0 0 0 0 0 0 0 0 0 0 0
0 0 0 0 0 0 0 0 0 0 129 162 0 0 0 1 1 1 0 0 0 0 0 0 0 0 0 0 0 0 0 0
1 1 1 1 1 1 0 0 0 0 129 162 0 0 0 24 24 23 0 0 0 0 0 0 0 0 0 0 0 0 0 0
24 23 23 24 24 23 0 0 0 0 0 0 0 0 0 0 0 0 129 162 0 0 0 0 0 0 0 0 0 0 0 0 0
0 0 0 0 0 0 0 0 0 0 0 0 0 0 0 0 0 0 129 162 0 0 0 0 0 0 0 0 0 0 0 0 0 
0 0 0 0 0 0 0 0 0 0 0 0 0 0 0 0 0 0 129 162 0 0 0 0 0 0 0 0 0 0 0 0 0 
0 0 0 0 0 0 0 0 0 129 162 0 0 0 129 162 0 0 129 162 0 0 0 0 0 0 0 0 0 0 0 0 
0 0 0 129 162 0 0 0 0 129 162 0 0 0 129 162 0 0 0 0 0 0 0 0 0 0 0 0 0 0 0 0
0 0 0 129 162 0 0 0 0 129 162 0 0 0 129 162 0 0 0 0 0 0 0 0 0 0 0 0 0 0 0 0  
32 31 32 129 162 31 32 31 32 129 162 31 32 31 129 162 32 31 32 31 32 31 32 31 32 31 32 31 32 31 32 31 
31 32 31 32 31 32 31 32 31 32 31 32 31 32 31 32 31 32 31 32 31 32 31 32 31 32 31 32 31 32 31 32
