TILEMAP
32 20 							-- Size of tile map in tiles
18 18 							-- Tile size & block size
images/tileset.png 	-- Tilesheet
32 6 								-- Number of tiles in tilesheet
11111111111111111111111111111111
11                            11
11                            11
11                            11
11                            11
11                            11
11                            11
1111   11111   1   1   111111 11
11           1 1 1 1 1        11
11                            11
11                            11
11                            11
1111   1111   33   44   11111 11
11                            11
11                            11
11              111           11
11                            11
1111   111  22       22  1111111
11              2             11
11111111111111111111111111111111

